{
  "act": 0,
  "chapter": 0,
  "tileMap": [
    [
      14, 14, 14, 14, 14, 14, 14, 14, 14, 14, 14, 14, 14, 14, 14, 14, 14, 14, 14, 14, 14, 14, 14, 14, 14, 14, 14, 14,
      14, 14, 14, 14, 14, 14, 14, 14, 14, 14, 14, 14, 14, 14, 14, 14, 14, 14, 14, 14, 14, 14
    ],
    [
      14, 13, 13, 13, 13, 13, 13, 14, 13, 13, 14, 13, 13, 13, 13, 13, 13, 13, 14, 13, 13, 13, 13, 13, 14, 14, 14, 14,
      14, 14, 14, 14, 14, 13, 13, 13, 13, 13, 13, 13, 13, 13, 13, 14, 14, 14, 14, 14, 14, 14
    ],
    [
      14, 13, 13, 13, 13, 13, 13, 14, 13, 13, 14, 13, 13, 13, 13, 13, 13, 13, 14, 13, 13, 13, 13, 13, 14, 14, 14, 14,
      14, 14, 14, 14, 14, 13, 13, 13, 13, 13, 13, 13, 13, 14, 14, 14, 14, 14, 14, 14, 14, 14
    ],
    [
      14, 13, 13, 13, 13, 13, 13, 14, 13, 13, 14, 13, 13, 13, 13, 13, 13, 13, 14, 13, 13, 13, 14, 13, 14, 14, 14, 14,
      14, 14, 14, 14, 14, 13, 13, 13, 13, 13, 13, 13, 13, 14, 14, 14, 14, 14, 14, 14, 14, 14
    ],
    [
      14, 14, 14, 14, 13, 14, 14, 14, 13, 13, 14, 13, 13, 13, 13, 13, 13, 13, 14, 13, 13, 14, 14, 13, 14, 100, 100, 100,
      13, 13, 13, 13, 14, 13, 13, 13, 13, 13, 13, 13, 13, 14, 14, 14, 14, 14, 14, 14, 14, 14
    ],
    [
      14, 14, 13, 13, 13, 13, 13, 13, 13, 13, 14, 14, 14, 14, 11, 14, 14, 14, 14, 13, 13, 14, 14, 13, 14, 100, 9, 100,
      13, 7, 7, 7, 14, 13, 13, 13, 13, 13, 13, 13, 14, 14, 14, 14, 14, 14, 14, 14, 14, 14
    ],
    [
      11, 14, 13, 13, 13, 13, 14, 14, 13, 13, 13, 13, 13, 13, 13, 13, 13, 13, 13, 13, 13, 13, 14, 13, 14, 100, 100, 100,
      13, 7, 1000, 7, 14, 13, 13, 13, 13, 13, 13, 13, 11, 14, 14, 14, 14, 14, 14, 14, 14, 14
    ],
    [
      14, 14, 13, 13, 13, 13, 14, 14, 13, 13, 13, 14, 14, 13, 13, 14, 14, 13, 13, 13, 13, 13, 13, 13, 11, 7, 7, 13, 13,
      7, 1000, 7, 11, 13, 13, 13, 13, 13, 13, 13, 14, 14, 14, 14, 14, 14, 14, 14, 14, 14
    ],
    [
      14, 13, 13, 13, 13, 13, 13, 13, 13, 13, 13, 14, 14, 13, 13, 14, 14, 13, 13, 13, 13, 13, 14, 13, 14, 1000, 7, 7, 7,
      7, 1000, 1000, 14, 13, 13, 13, 13, 13, 13, 13, 14, 14, 14, 14, 14, 14, 14, 14, 14, 14
    ],
    [
      14, 14, 14, 14, 13, 14, 14, 14, 13, 13, 13, 13, 13, 13, 13, 13, 13, 13, 13, 13, 13, 14, 14, 13, 14, 1000, 1000,
      1000, 1000, 1000, 1000, 1000, 14, 13, 13, 13, 13, 13, 13, 13, 13, 14, 14, 14, 14, 14, 14, 14, 14, 14
    ],
    [
      1000, 100, 13, 13, 13, 13, 13, 14, 13, 13, 13, 14, 14, 14, 14, 14, 14, 13, 13, 13, 13, 14, 14, 13, 14, 14, 14, 14,
      14, 14, 14, 14, 14, 13, 13, 13, 13, 13, 13, 13, 13, 13, 14, 14, 14, 14, 14, 14, 14, 14
    ],
    [
      1000, 100, 100, 13, 13, 13, 13, 14, 13, 13, 13, 14, 13, 13, 13, 13, 14, 13, 13, 13, 13, 13, 14, 13, 14, 14, 14,
      14, 14, 14, 14, 14, 14, 13, 13, 13, 13, 13, 13, 13, 13, 13, 13, 14, 14, 14, 14, 14, 14, 14
    ],
    [
      1000, 1000, 100, 100, 13, 13, 13, 14, 13, 13, 13, 11, 13, 13, 13, 13, 14, 13, 13, 13, 13, 13, 13, 13, 14, 14, 14,
      14, 14, 14, 14, 14, 14, 13, 13, 13, 13, 13, 13, 13, 13, 13, 13, 14, 14, 14, 14, 14, 14, 14
    ],
    [
      1000, 1000, 1000, 100, 100, 13, 100, 14, 13, 13, 13, 14, 13, 13, 13, 13, 14, 13, 13, 13, 13, 13, 13, 13, 14, 14,
      14, 14, 14, 14, 14, 14, 14, 13, 13, 13, 13, 13, 13, 13, 13, 13, 13, 13, 14, 14, 14, 14, 14, 14
    ],
    [
      1000, 1000, 1000, 1000, 1000, 1000, 1000, 14, 14, 14, 14, 14, 14, 14, 14, 14, 14, 14, 14, 14, 14, 14, 14, 14, 14,
      14, 14, 14, 14, 14, 14, 14, 14, 14, 14, 14, 14, 14, 14, 14, 14, 14, 14, 14, 14, 14, 14, 14, 14, 14
    ]
  ]
}
