{
  "act": 5,
  "chapter": 5,
  "tileMap": [
    [1000, 1000, 1000, 1000, 0, 0, 0, 0, 0, 0],
    [1000, 1000, 1000, 1000, 0, 0, 0, 0, 0, 0],
    [1000, 1000, 1000, 1000, 0, 0, 0, 0, 0, 0],
    [1000, 1000, 1000, 1000, 0, 0, 0, 0, 0, 0],
    [0, 0, 0, 0, 0, 0, 0, 0, 0, 0],
    [0, 0, 0, 0, 0, 0, 0, 0, 0, 0],
    [0, 0, 0, 0, 0, 0, 0, 0, 0, 0],
    [0, 0, 0, 0, 0, 0, 0, 0, 0, 0, 0],
    [0, 0, 0, 0, 0, 0, 0, 0, 0, 0],
    [0, 0, 0, 0, 0, 0, 0, 0, 0, 0]
  ]
}
