[
  [5,5,5,2,0,0,0,0,0,0,0,0,0,0,0],
  [3,4,3,2,1,1,1,1,1,1,1,1,1,1,0],
  [1,7,1,2,1,1,1,1,1,1,1,1,1,1,0],
  [1,7,1,2,1,1,1,1,1,1,1,1,1,1,0],
  [1,7,8,2,1,1,1,1,1,1,1,1,1,1,0],
  [1,7,7,7,7,7,7,1,1,1,1,1,1,1,0],
  [1,1,1,2,1,1,7,1,1,1,1,1,1,1,0],
  [2,2,2,2,1,1,7,1,1,1,1,1,1,1,0],
  [0,1,1,1,1,1,7,1,1,1,1,1,1,1,0],
  [0,0,0,0,1,1,7,7,7,7,7,7,7,1,0],
  [0,1,1,1,1,1,7,1,1,1,1,1,7,1,0],
  [0,1,1,1,1,1,7,1,1,1,1,1,7,1,0],
  [0,1,1,1,1,1,7,1,1,1,1,1,7,1,0],
  [0,1,1,1,1,1,7,1,1,1,1,1,7,7,7],
  [0,0,0,0,0,0,0,0,0,0,0,0,0,0,6]
]