[
  [7,7,0,0,0,0,0,0,0,0,0,0,0,0,0],
  [0,7,0,2,2,2,2,2,1,1,1,1,1,1,0],
  [0,7,0,2,5,5,5,2,1,1,1,1,1,1,0],
  [0,7,0,2,3,4,3,2,1,1,1,1,1,1,0],
  [0,7,2,2,2,7,2,2,1,1,1,1,1,1,0],
  [0,7,2,1,1,7,1,1,1,1,1,1,1,1,0],
  [0,7,7,7,7,7,7,7,1,1,1,1,1,1,0],
  [0,1,2,1,1,1,1,7,1,1,1,1,1,1,0],
  [0,1,2,1,1,1,1,7,1,1,1,1,1,1,0],
  [0,0,2,1,1,1,1,7,1,1,1,1,1,1,0],
  [0,1,2,1,1,1,1,7,1,1,1,1,1,1,0],
  [2,2,2,1,1,1,1,7,1,1,1,1,1,1,0],
  [0,1,1,1,1,1,1,7,1,1,1,1,1,1,0],
  [0,1,1,1,1,1,1,7,7,7,7,7,7,7,1],
  [0,0,0,0,0,0,0,0,0,0,0,0,0,7,7]
]