[
  [0,0,0,0,0,0,0,0,0,0,0,0,0,0,0,0,0,0,0,0,0,0,0,0,0,0,0,0,0,0],
  [0,0,0,0,0,0,0,0,5,5,5,0,0,0,0,0,0,1,0,1,1,1,0,0,7,7,7,0,0,0],
  [1,0,0,1,0,1,0,0,3,4,3,1,1,1,1,1,1,1,1,1,1,1,0,1,7,0,7,1,1,1],
  [7,7,7,7,7,1,1,0,1,7,1,1,1,1,1,7,1,1,1,1,1,1,0,1,7,2,7,1,1,1],
  [1,1,0,7,7,7,7,7,7,7,7,7,7,7,7,7,7,7,7,7,7,7,7,7,7,2,7,7,7,7],
  [1,0,0,0,0,1,1,1,1,0,1,5,5,5,1,1,7,1,1,0,1,1,1,1,0,2,1,1,1,1],
  [0,0,1,1,0,0,0,0,0,0,1,9,3,9,0,0,7,1,1,0,0,0,0,0,0,2,0,0,0,0],
  [0,0,0,0,0,0,0,0,0,0,0,0,0,0,0,0,7,0,0,0,0,0,0,0,0,2,0,0,0,0]
]