[
  [1,1,0,0,0,0,0,0,0,0,0,0,0,0,0],
  [0,1,0,1,1,1,1,1,1,1,1,1,1,1,0],
  [0,1,0,1,5,5,5,1,1,1,1,1,1,1,0],
  [0,1,0,1,3,4,3,1,1,1,1,1,1,1,0],
  [0,1,2,2,2,1,1,1,1,1,1,1,1,1,0],
  [0,1,2,1,1,1,1,1,1,1,1,1,1,1,0],
  [0,1,2,1,1,1,1,1,1,1,1,1,1,1,0],
  [0,1,2,1,1,1,1,1,1,1,1,1,1,1,0],
  [0,1,1,1,1,1,1,1,1,1,1,1,1,1,0],
  [0,0,0,0,1,1,1,1,1,1,1,1,1,1,0],
  [0,1,1,1,1,1,1,1,1,1,1,1,1,1,0],
  [0,1,1,1,1,1,1,1,1,1,1,1,1,1,0],
  [0,1,1,1,1,1,1,1,1,1,1,1,1,1,0],
  [0,1,1,1,1,1,1,1,1,1,1,1,1,1,1],
  [0,0,0,0,0,0,0,0,0,0,0,0,0,0,6]
]