{
  "act": 0,
  "chapter": 2,
  "tileMap": [
    [14, 14, 14, 14, 14, 11, 14, 14, 14, 14, 14, 14],
    [14, 14, 14, 14, 14, 13, 14, 14, 14, 14, 14, 14],
    [14, 14, 14, 14, 13, 13, 13, 14, 14, 14, 14, 14],
    [14, 14, 14, 13, 13, 13, 13, 13, 14, 14, 14, 14],
    [14, 14, 14, 13, 13, 13, 13, 13, 13, 14, 14, 14],
    [14, 14, 14, 13, 13, 13, 13, 13, 13, 13, 14, 14],
    [14, 13, 13, 13, 13, 13, 13, 13, 13, 13, 13, 14],
    [14, 13, 13, 13, 13, 13, 13, 13, 13, 13, 13, 14],
    [14, 14, 14, 14, 14, 13, 13, 14, 14, 14, 14, 14],
    [14, 14, 14, 14, 14, 13, 13, 14, 14, 14, 14, 14],
    [14, 14, 14, 14, 14, 13, 13, 14, 14, 14, 14, 14],
    [14, 14, 14, 14, 14, 13, 13, 14, 14, 14, 14, 14],
    [14, 14, 14, 14, 14, 13, 13, 14, 14, 14, 14, 14],
    [14, 14, 14, 14, 14, 14, 13, 14, 14, 14, 14, 14],
    [14, 14, 14, 14, 14, 14, 13, 14, 14, 14, 14, 14],
    [14, 14, 14, 14, 14, 14, 13, 14, 14, 14, 14, 14],
    [14, 14, 14, 14, 14, 14, 13, 14, 14, 14, 14, 14],
    [14, 14, 14, 14, 14, 14, 13, 14, 14, 14, 14, 14],
    [14, 13, 13, 13, 13, 13, 13, 14, 14, 14, 14, 14],
    [14, 13, 14, 14, 14, 14, 14, 14, 14, 14, 14, 14],
    [14, 13, 14, 14, 14, 14, 14, 14, 14, 14, 14, 14],
    [14, 13, 14, 14, 14, 14, 14, 13, 13, 13, 13, 14],
    [14, 13, 14, 14, 14, 14, 14, 13, 13, 13, 13, 14],
    [14, 13, 14, 14, 14, 14, 14, 13, 13, 13, 13, 14],
    [14, 13, 13, 13, 13, 13, 13, 13, 13, 13, 13, 14],
    [14, 14, 14, 14, 14, 14, 13, 13, 13, 13, 13, 14],
    [14, 14, 14, 14, 14, 14, 13, 13, 13, 13, 13, 14],
    [14, 14, 14, 14, 14, 14, 13, 13, 13, 13, 13, 14],
    [14, 14, 14, 14, 14, 14, 13, 13, 13, 13, 13, 14],
    [14, 14, 14, 14, 14, 14, 13, 13, 13, 13, 13, 14],
    [14, 14, 14, 14, 14, 14, 13, 13, 13, 13, 13, 14],
    [14, 14, 14, 14, 14, 14, 13, 13, 13, 13, 13, 14],
    [14, 14, 14, 14, 14, 14, 13, 13, 13, 13, 13, 14],
    [14, 14, 14, 14, 14, 14, 13, 13, 13, 13, 13, 14],
    [14, 14, 14, 14, 14, 14, 13, 13, 13, 13, 13, 14],
    [14, 14, 14, 14, 14, 14, 13, 13, 13, 13, 13, 14],
    [14, 14, 14, 14, 14, 14, 13, 13, 13, 13, 13, 14],
    [14, 14, 14, 14, 14, 14, 13, 13, 13, 13, 13, 14],
    [14, 13, 13, 13, 13, 13, 13, 13, 13, 13, 13, 14],
    [14, 13, 13, 13, 13, 13, 13, 13, 13, 13, 13, 14],
    [14, 13, 13, 13, 13, 13, 13, 13, 13, 13, 13, 14],
    [14, 14, 14, 14, 14, 14, 13, 13, 13, 13, 13, 14],
    [14, 14, 14, 14, 14, 14, 13, 13, 13, 13, 13, 14],
    [14, 14, 14, 14, 14, 14, 13, 13, 13, 13, 13, 14],
    [14, 14, 14, 14, 14, 14, 13, 13, 13, 13, 13, 14],
    [14, 14, 14, 14, 14, 14, 13, 13, 13, 13, 13, 14],
    [14, 14, 14, 14, 14, 14, 13, 13, 13, 13, 13, 14],
    [14, 14, 14, 14, 14, 14, 13, 13, 13, 13, 13, 14],
    [14, 14, 14, 14, 14, 14, 13, 13, 13, 13, 13, 14],
    [14, 14, 14, 14, 14, 14, 13, 13, 13, 13, 13, 14],
    [14, 14, 14, 14, 14, 14, 13, 13, 13, 13, 13, 14],
    [14, 14, 14, 14, 14, 14, 13, 13, 13, 13, 13, 14],
    [14, 14, 14, 14, 14, 14, 13, 13, 13, 13, 13, 14],
    [14, 14, 14, 14, 14, 14, 13, 14, 14, 14, 14, 14],
    [14, 14, 14, 14, 14, 14, 13, 14, 14, 14, 14, 14],
    [14, 14, 14, 14, 14, 14, 13, 14, 14, 14, 14, 14],
    [14, 14, 14, 14, 14, 14, 13, 14, 14, 14, 14, 14],
    [14, 14, 14, 14, 14, 14, 13, 14, 14, 14, 14, 14],
    [14, 14, 14, 14, 14, 14, 13, 14, 14, 14, 14, 14],
    [14, 14, 14, 14, 14, 14, 13, 14, 14, 14, 14, 14],
    [14, 14, 14, 14, 14, 14, 13, 14, 14, 14, 14, 14],
    [14, 14, 14, 14, 14, 13, 13, 14, 14, 14, 14, 14],
    [14, 14, 14, 14, 14, 13, 14, 14, 14, 14, 14, 14],
    [14, 13, 13, 13, 14, 13, 14, 13, 13, 13, 13, 14],
    [14, 13, 13, 13, 14, 13, 14, 13, 13, 13, 13, 14],
    [14, 13, 13, 13, 14, 13, 14, 13, 13, 13, 13, 14],
    [14, 13, 13, 13, 14, 13, 14, 13, 13, 13, 13, 14],
    [14, 13, 13, 13, 14, 13, 14, 13, 13, 13, 13, 14],
    [14, 13, 13, 13, 14, 13, 14, 13, 13, 13, 13, 14],
    [14, 13, 13, 13, 11, 13, 11, 13, 13, 13, 13, 14],
    [14, 14, 14, 14, 14, 13, 14, 14, 14, 14, 14, 14],
    [14, 13, 13, 13, 11, 13, 11, 13, 13, 13, 13, 14],
    [14, 13, 13, 13, 14, 13, 14, 13, 13, 13, 13, 14],
    [14, 13, 13, 13, 14, 13, 14, 13, 13, 13, 13, 14],
    [14, 13, 13, 13, 14, 13, 14, 13, 13, 13, 13, 14],
    [14, 13, 13, 13, 14, 13, 14, 13, 13, 13, 13, 14],
    [14, 13, 13, 13, 14, 13, 14, 13, 13, 13, 13, 14],
    [14, 13, 13, 13, 14, 13, 14, 13, 13, 13, 13, 14],
    [14, 14, 14, 14, 14, 11, 14, 14, 14, 14, 14, 14],
    [14, 14, 14, 14, 14, 14, 14, 14, 14, 14, 14, 14]
  ]
}
